NO ./textures/dust2/north.png
EA ./textures/dust2/east.png
SO ./textures/dust2/south.png
WE ./textures/dust2/west.png
DO ./textures/dust2/door.png

C 203,231,237
F 237,216,161

 1111                                                       111111111111     
 1001                                                       110000000001     
 1001111111111                                 111111111    100000000001     
 100000000000111111111                         1000000011111100000000001     
 1000000000000000000011111111                  1000000000000000000000001    
110000000000000000000000000011111             11000000000000000000000001    
100000000000000000000000000000001111111111111110000000000000000000000001    
100000000000000001000000000000000000000000000000000000000000000000000001    
1000000000000000010000000000000000000000000000000000000000000000000000011111
10000000000000000200000000000000000000S0000000000000000000000000000000000001
1000000000000000020000000000000000000000000000000000000000000000000000000001
1000000000000000020000000000000000000000000000000000000000000000000000000001
1000000000000000010000000000000000000000000000000000000000000000000000000001
1000000000000000010000000000000000000000000000000000000000000000000000000001
1000000000000001111111111111111111111222111111111111000000111111110000000001
1000000000000001                  100000001        10000001      10000000001
1110000111100001                  100000001        10000001      10000000111
  100001  100011                  100000001        10000001      100000001  
  100001  11111                   111000001        10000001      100000001  
  100001              111111111111  10000011111111110000001      100000001  
  100001              1000000000011110000000000000000000001      100000001  
  100001              1000000000000000000000000000000000001      100000001  
  100001              1000000000000000000000000000000000001      100000001  
  100001111           1000000000000000000000000000000000001      100000001  
  100000001           1000000000000000000000000000000000001      100000001  
  100000001111111111111000000001111110000001111111111111111      100000001  
11100000000000000000000000000001    10000001                     100000001  
10000000000000000000000000000001    10000001                     100000001  
10000000000000000000000000000001    10000001                     100000001  
10000000000000000000000000000001    10000001         111111111111100000001  
11111110000011111111111111111111    10000001         100000000000000000001  
      1000001                       10000001         100000000000000000001  
 111111000001111                    10000001         100000000000000000001  
 100000000000001                  1110000001         1222111110000000000011 
 100000000000001                  10000000011        1000001 10000000000001 
 100000000000001                  10000000001111111  1000001 10000000000001 
 100000000000001                  10000000000000001  1000001 10000000000001 
 100000000000001                  10000000000000001111112221 10000000111111 
 100000000000001                  10000000000000000000000001 100000001      
 100000000000001                  11000000000000000000000001 100000001      
 100000000000001                   1000000000000000000000001 111111111      
 100000000000001                   1110000000000000000000001                
 100000000000111                     11000001111111100000001                
 1000000000001                        1000001      100000001                
 1000000000001111111                  1000001      100000001                
 1000000000000000001                  1000001      100000001                
 1000000000000000001                  1000001111111100000001                
 10000000000000000011111111111111111111000000000000000000111                
 100000000000000000000000000000000000000000000000000000001                  
 100000000000000000000000000000000000000000000000000000001                  
 100000000000000000000000000000000000000000000000000000001                  
 100000000000000000000000000000000000000000000000000000001                  
 100000000000000000000000000000000000000000000000000000001                  
 100000000000000000000000000000000000000000000000000000001                  
 111111111111111111111111111111111111111111111111111111111                  
